17 17 8 8
00221111111111100
02211111111111110
22111111111111111
21222111111111111
11122111111111111
11111111111111111
11111222111111111
11111121221111111
11111112221111111
11111112212111111
11111111122211111
11111111111111111
11111111111122111
11111111111122212
11111111111111122
01111111111111220
00111111111112200